0000000000000000000000000000000000000000000000000000000000000000000000000
0000000000000000000000000000000000000122223000000000000000000000000000000
0000000000000000000000000000000000000444444000000000000000000000000000000
00000000C0000000000000000000000000000655557000000000000000000000000000000
00000012223000000000C0000000000000000000000000000000000000000000000000000
00000065557000000012230000000000000000000000000000000000C0000000000000000
0000000000000000006557000000000000000000000000000000000A98000000000000000
0000000000000000000000000000000000000000000000000000000000000000000000000
0000000000000000000000000000000000000000000000000000000000000000000000000
0000000000000e00e0000e000000e000000000e0000000000000000000000000000000000
2222222222222222222222222222222222222222222222222222222222222222222222222
4444444444444444444444444444444444444444444444444444444444444444444444444
4444444444444444444444444444444444444444444444444444444444444444444444444